##########
#        #
#        #
#        #
#   .o   #####
#           @#
##############




##########
#        #
#    .   #
#    o   #
#        #
#       @#
##########