##########
#        #
#    o   #
#  o..   #
#  o..o  #####
#           @#
##############